##########
#        #
#   $ $  #
# ###   ##
#   # ###
 ## # # 
#   # #
# ### ###
#  ##   ##
#+      .#
##########
